1. Rock

    Blackbird – The Beatles

    Kashmir – Led Zeppelin

    Layla

    Hysteria – Muse

    The Trooper – Iron Maiden

    Under the Bridge – Red Hot Chili Peppers

    Hyperballad – Björk

    Seven Nation Army – The White Stripes

    Time Is Running Out – Muse

    Nothing Else Matters – Metallica

    Road of the gypsy - Adrenalin

2. Pop

    Royals – Lorde

    Chandelier – Sia

    Happy – Pharrell Williams

    Bad Guy – Billie Eilish

    Rolling in the Deep – Adele

    Don’t Start Now – Dua Lipa

    Get Lucky – Daft Punk ft. Pharrell Williams

    All Too Well (10 Minute Version) – Taylor Swift

    Blinding Lights – The Weeknd

3. Hip-Hop / Rap

    N.Y. State of Mind – Nas

    HUMBLE. – Kendrick Lamar

    Shook Ones, Pt. II – Mobb Deep

    God’s Plan – Drake

    SICKO MODE – Travis Scott

    Juicy – The Notorious B.I.G.

    DNA. – Kendrick Lamar

    Lose Yourself – Eminem

    Mask Off – Future

    All Falls Down – Kanye West

4. Electronic / Dance

    Windowlicker – Aphex Twin

    Strobe – deadmau5

    Xtal – Aphex Twin

    Adrenaline – ZHU

    Voodoo People (Pendulum Remix) – The Prodigy

    Opus – Eric Prydz

    Eple – Röyksopp

    HyperParadise (Flume Remix) – Hermitude

    Go – The Chemical Brothers

    Porcelain – Moby

5. Jazz

    Take Five – Dave Brubeck Quartet

    Blue in Green – Miles Davis

    Naima – John Coltrane

    So What – Miles Davis

    Chameleon – Herbie Hancock

    Footprints – Wayne Shorter

    Moanin’ – Art Blakey & Jazz Messengers

    Song for My Father – Horace Silver

    Spain – Chick Corea

    Acknowledgment – John Coltrane

6. Classical / Orchestral

    Rite of Spring (Stravinsky) – “Dance of the Earth”

    Carmina Burana – “O Fortuna”

    Shostakovich: Symphony No. 5 (mvt. I)

    Bartók: Concerto for Orchestra (mvt. II)

    Debussy: Prelude to the Afternoon of a Faun

    Ligeti: Atmosphères

    Mozart: Clarinet Concerto in A (mvt. II)

    Vivaldi: Winter (Four Seasons, mvt. I)

    Beethoven: Moonlight Sonata (mvt. I)

    Ravel: Daphnis et Chloé Suite No. 2

7. Blues

    Bright Lights, Big City – Jimmy Reed

    Crosscut Saw – Albert King

    Red House – Jimi Hendrix

    Texas Flood – Stevie Ray Vaughan

    I’d Rather Go Blind – Etta James

    Stormy Monday – T-Bone Walker

    Messin’ with the Kid – Junior Wells

    Mannish Boy – Muddy Waters

    The Thrill Is Gone – B.B. King

    Statesboro Blues (Live) – The Allman Brothers Band

8. Country / Folk

    Will the Circle Be Unbroken – Nitty Gritty Dirt Band

    Girl from the North Country – Bob Dylan & Johnny Cash

    Pancho and Lefty – Townes Van Zandt

    Long Black Veil – The Chieftains ft. Sinead O’Connor

    Jolene – Dolly Parton

    If We Were Vampires – Jason Isbell

    Follow the Drinking Gourd FTDGTM – Doc Watson

    Blue Eyes Crying in the Rain – Willie Nelson

    Angel from Montgomery – John Prine

    Black Sheep – Nathaniel Rateliff & The Night Sweats

9. Reggae

    Exodus – Bob Marley & The Wailers

    King Tubby Meets the Rockers Uptown – Augustus Pablo

    Night Nurse – Gregory Isaacs

    Roots, Rock, Reggae – Bob Marley

    Declaration of Rights – A.O.R. Band

    Israelites – Desmond Dekker

    Satta Massagana – The Abyssinians

    Funky Kingston – Toots & The Maytals

    Johnny Too Bad – The Slickers

    Two Sevens Clash – Culture

    Survivor - Nathaniel Rateliff

10. Latin / World

    Chan Chan – Buena Vista Social Club

    Oye Como Va – Santana

    Tamacun – Rodrigo y Gabriela

    Desert Rose – Sting ft. Cheb Mami

    Mambo No. 5 – Pérez Prado

    La Tortura – Shakira ft. Alejandro Sanz

    Libertango – Astor Piazzolla

    Zangaléwa – Golden Sounds

    Alfonsina y el Mar – Mercedes Sosa

    Tamacun (Live) – Rodrigo y Gabriela